%%%%%%%%%%
%     %  %
%   %    %
%P%%%%%%*%
%        %
%%%%%%%%%%